################
#..............#
#..S...........#
#..............#
#..............#
#..............#
#..............#
#.............G#
################

################
#..............#
#..............#
#..............#
#..............#
#..............#
#..............#
#..............#
################
