################
#..............#
#..S.....######G
#........#.....#
#..######.#.####
#..#......#....#
#..#.####.#.####
#..#.#..#.#....#
################
